1111111111111111111111
1P10001011101111100111
1010101111111111100001
1000000000C00000001001
1011101011111010111011
1111111011101010001011
10C0111011111010111011
1010101011111110101011
11100111100011101C0011
1000C00C0010000000E011
1111111111111111111111